8|8
0,15,0,0,0,3,3,3
0,30,30,0,1,3,3,3
15,20,20,0,0,0,3,3
0,0,0,4,4,0,0,0
0,0,0,4,4,0,0,0
0,0,0,0,0,20,20,15
0,0,0,0,0,30,30,0
0,0,0,0,15,0,0,0
