8|8
0,10,0,0,0,3,3,3
0,30,30,0,1,3,3,3
10,20,20,0,0,0,3,3
0,0,0,4,4,0,0,0
0,0,0,4,4,0,0,0
0,0,0,0,0,20,20,10
0,0,0,0,0,30,30,0
0,0,0,0,10,0,0,0
